1111111
1P00001
1000001
1011111
100E0C1
1111111